XXXXXXXXXXXXXXX             
  XXXXXXXX   X             X
  X      XX  X  # # # # XX X
  X XX X  XXXX  ## # # #   X
  X     X XX  #  ## # # #  X
  X X X    X ## #   # # #  X
  X X    X X   #Y#  # # #  X
  X X  X   XXX  ## # # # XXX
 XX XXXX    XXX   # # #  X  
 X. ....X   XXX X XXXXXXXX  
 X. ....X         X         
 X. ....X X XXXXXXX         
XX. ....X   X               
X.  ....X XXX               
X.  ....  X                 
XX. ....XXX                 
 XXXXXXXX                    